1111111111111111111111111111111111
1010000000100000001000000000000001
10P00000001000000010000000C0000001
10000000001C0000000000000000000001
10000C00000011000001000E0000000001
1000000000001100000100000000000001
1111111111111111111111111111111111