111111111
100000001
100000001
100C00C01
100P00E01
100000001
111111111