11111111111
11110C01111
11110C01111
11110001111
11110C01111
10000000001
1C0C0P000E1
10C0000C001
11110001111
11110C01111
11110001111
11111111111